################################
#..............................#
#..###.........................#
#..............................#
#...............@..............#
#..............................#
#..............................#
#..............................#
#.....................++.......c
#..............................#
#..............................#
#..............................#
#..............................#
#..............................#
#..............................#
#..............................#
#..............................#
################################
