################################
#..............................#
#.#............................#
#..............................#
#..............................#
#..............................#
#..............................#
#..............................#
#..............@......++.......c
#..............................#
#..............................#
#..............................#
#..............................#
#..............................#
#..............................#
#..............................#
#..............................#
################################
