################################
#..............................#
#.#............................#
#....d.........................#
#..............................#
#..............................#
#....#.........................#
#......#.......................#
#..............@......+++++....c
#..............................#
#..............................#
#..............................#
#...#.....l....................#
#..............................#
#............r......#..........#
#......u.......................#
#..............................#
################################
