################################
#..............................#
#...####.......................#
#..............................#
#..............................#
#..............................#
#..............................#
#..............................#
#..............@......++.......c
#..............................#
#..............................#
#..............................#
#..............................#
#..............................#
#..............................#
#..............................#
#..............................#
################################
