################################
#...+..........................#
#.+.......+......+......+..+.+.#
#....+......++......###....+...#
#.+.####...........+....+..#...#
#...+....+.....+..........##...#
#..+..+.+..#...#######...##..+.#
###.+.+....#.+..........##.....#
#@#.#..+...##....+....+.#.....+c
#.#.#....+..#.......+......#...#
#.#.#.##..+.#...+........+.##..#
#.#.#..#........+......+....#..#
#.#....#..+.......####......#..#
#.#.+.#......+...####.....+.#+.#
#.#...##.......###.....+.......#
#.#....#..#...++##....#..+##...#
#....+...##.........+.##...#..+#
################################
