################################
#.......++....+......+...#+++++#
#.######################.##++++#
#.#++++++....+...+.#####..####.#
#.#++++++#########.#.+....+++#.#
#+######+#########.#.#########.#
#......#++++++#+..+#.#+....+...#
######.########.####+#.#########
#@...#.+.++...+.#....#.##....+.c
#....############+####.#..######
#.........+..+....#....#.##..+.#
#....##############..+.#+#..+..#
#.............+.....####.#.###+#
#....###################.#+#+#.#
#.....++...++..++....++..#.++#.#
#....#########################.#
#.....+...+...+...+...+..+....+#
################################
