################################
#++++++++++++++++++++++++++++++#
#..####..#...#.....####.#..#.++#
#..#...#.#...#.......+#.#++#...#
#..#...#.+#+#+.......+#.####...#
#..####+...#.......####...+#...#
#..#.......#.......#+.....+#...#
#..#.......#...#...####...+#...#
#@++++++++++++++++++++++++++++.c
#...###....#...#...#.#####.....#
#..#...#..#.#..##+##.#+..#.....#
#..#.....#...#.#+#+#.###.......#
#..#..##.#####.#...#.###.......#
#..#..+#.#.+.#.#...#.#+..#.....#
#...###..#...#.#...#.#####.....#
#............................++#
#++++++++++++++++++++++++++++++#
################################
