################################
#....#..#......#..#.......#..#.#
#.+#.#.+....+#.#.+.....+#.#.+..#
#.#.....#...#.....#....#.....#.#
#...#.#.#.....#.#.#......#.#.#.#
#.##.+##....##.+##.....##.+##..#
#...##........##.........##....#
#.+.....#...+.....#....+.....#.#
##.#..#..#.#.#..#...#.#.#..#...c
#.#.........#.......#..#.......#
##..+.#.#..#..+.#.#.###..+.#.#.#
#..#.#.......#.#...#....#.#....#
#+..#..#...+..#..#....+..#..#..#
##....#.+..#....#.+...#....#.+.#
#.#+.#.#....#+.#.#.....#+.#.#..#
#+.#..+.#.#+.#..+.#...+.#..+.#.#
#@.............................#
################################
