################################
#...#........#........#.......##
#.#.#..###.#.#..###.#.#..####.##
#......+.#......+.#......+.#...#
#..+....+#..+....+#..+....+#.+.#
#...#..##....#..##....#..##...##
##.#...#..#.#...#..#.#...#...#.#
#..#.#...#..#.#...#..#.#...#.#.#
#@##...+...##...+...##...+..##.c
#.....+..+.....+..+.....+..+...#
#+#.......+#.......+#.......#..#
#..#.+#..#..#.+#..#..#.+#..#.#.#
#..#........#........#.......#.#
##...#.+###...#.+###...#.+##...#
##+#......#+#......#+#......+#.#
#+##.##.#.+##.##.#.+##.##.#.##.#
#....+.+......+.+......+.+.....#
################################
