################################
#..........+...#..........+...##
#..###+..#..##.#..###+..#..##.##
#..+.#..+##.......+.#..+##.....#
#...+##..#....+....+##..#....+.#
#..##..#....#..#..##..#....#..##
#..#...#.#.+#.#...#...#.#.+#.#.#
##...##.......#.#...##.......#.#
#@.+..#.+..#.##...+..#.+..#.##.c
#.+..+.#...#.....+..+.#...#....#
#......#..#.+#........#..#.+#..#
#+#..#..#.#...#.+#..#..#.#...#.#
#.......#.....#........#.....#.#
##.+##..+#+##...#.+##..+#+##...#
#......#.#..#+#.......#.#..#+#.#
###.#.#..#.#+##.##.#.#..#.#+##.#
#+.+..+..#......+.+..+..#......#
################################
