################################
#+..##.........................#
#+..#####...##..#..............#
#++.#...##...####..+++++++.....#
#.+.##..##....++...++++++++....#
#.+.#####.....##++++++++++++...#
#...#........##+++++++++++++...#
#...#.+++++..#.+++++++++++++#..#
#@....+++++.##+++++++++++++.#..c
#..............+++.......++.#..#
#....###.###.#............+.#..#
#....#...#...#.....##..###..#..#
#.++.#...#...####.####.####.#..#
#.++.##..#...##.#.#..#.#..#.#..#
#..++.##.#...#..#.#..#.#..#.#..#
#..++..#.###.#..#.####.####.#..#
#....###.......................#
################################
