################################
#..............................#
#.....##.....##................#
#.###.###.##.###......###......#
#.#+#.#+.###.#+#......#+#......#
#.#...##.#+#.#.#..###.#.####...#
#.###....#.........+#...##+....#
#.........##......###....###...#
#@.............................c
#..............................#
#.#...#..##..#..#.###+.###.#.#.#
#..#+#..#..#.##+#.#..#.#+..#+#.#
#..+#+..#..#.#+##.#..#.##..+#+.#
#...#...####.#..#.#..#.#+..#+#.#
#...#...#++#.#..#.###+.###.#.#.#
#..............................#
#..............................#
################################
