################################
#+++++++++++++++++++++++++++++l#
#..####..#...#.....####.#..#.++#
#..#...#.#...#.......+#.#++#...#
#..#...#.+#+#+.......+#.####...#
#..####+...#.......####...+#...#
#..#.......#.......#+.....+#...#
#..#.......#...#...####...+#...#
#@++++++++++++++++++++++++++++lc
#...###....#...#...#.#####.....#
#..#...#..#.#..##+##.#+..#.....#
#..#.....#...#.#+#+#.###.......#
#..#..##.#####.#...#.###.......#
#..#..+#.#.+.#.#...#.#+..#.....#
#...###..#...#.#...#.#####.....#
#.............lr.............++#
#r+++++++++++++++++++++++++++++#
################################
