################################
####################...........#
#################..######......#
######.+.+.+#++.+....+..#......#
######.####.#+#.#####+#.#......#
######+#..#+#+#...#...#.#......#
######.#..#.#+###.#...#+#......#
####.#.#..#.#+###.#...#.#...####
#@##.#+#..#+#+###.#...#.#...#..c
#.#+.#.#..#.#+###.#...#.#...#..#
#+#+##.#..#.#+###.#...#.#...#.+#
#.#+.#+#..#+#+###.#...#+#...#..#
#+##.#.#..#.#+###.#...#.#...#..#
#.#+.#.#..#.#####.#...#.#...#+.#
#+#.##+#..#+#####.#...#.#...#..#
#.####.#..#.#####.#...#.#####..#
#.+.+.+#..#r+++++l#...#..+....+#
################################
