################################
#..............................#
#..#######.....................#
#..............................#
#..............................#
#..............................#
#..............................#
#..............................#
#..............@......++.......c
#..............................#
#..............................#
#..............................#
#..............................#
#..............................#
#..............................#
#..............................#
#..............................#
################################
